x x x x x x x x x x x x x x x x x x x x x
x o o o o o o o o o x o o o o o o o o o x
x o x x x o x x x o x o x x x o x x x o x
x y x x x o x x x o x o x x x o x x x y x
x o x x x o x x x o x o x x x o x x x o x
x o o o o o o o o o o o o o o o o o o o x
x o x x x o x o x x x x x o x o x x x o x
x o x x x o x o x x x x x o x o x x x o x
x o o o o o x o o o x o o o x o o o o o x
x x x x x o x x x e x e x x x o x x x x x
x x x x x o x e e e e e e e x o x x x x x
x x x x x o x e x x x x x e x o x x x x x
x x x x x o x e x e e e x e x o x x x x x
d e e e e o e e x e e e x e e o e e e e f
x x x x x o x e x x x x x e x o x x x x x
x x x x x o x e e e e e e e x o x x x x x
x x x x x o x e x x x x x e x o x x x x x
x x x x x o x e x x x x x e x o x x x x x
x o o o o o o o o o x o o o o o o o o o x
x o x x x o x x x o x o x x x o x x x o x
x y o o x o o o o o s o o o o o x o o y x
x x x o x o x o x x x x x o x o x o x x x
x x x o x o x o x x x x x o x o x o x x x
x o o o o o x o o o x o o o x o o o o o x
x o x x x x x x x o x o x x x x x x x o x
x o o o o o o o o o o o o o o o o o o o x
x x x x x x x x x x x x x x x x x x x x x